11111111111111111111
10010000C1000000C101
10C00001010000001001
1E0011C0010000C00001
10000000110100000C01
101000C100000C000101
10000000000100001001
100010000C00001000P1
1000101C000000000101
11111111111111111111
