1111111
100C011
1E01P01
1111111
